EA ./cube/image/WallR.xpm
WE ./cube/image/WallL.xpm
SO ./cube/image/WallD.xpm
NO ./cube/image/WallU.xpm

F 220,170,0
C 255,10,0

11111111111111
10000000000001
10000011110001
10000010010001
100N0011010001
10000000000001
11111111111111
