SO ./cube/image/WallD.xpm
EA ./cube/image/WallR.xpm
WE ./cube/image/WallL.xpm
NO ./cube/image/WallU.xpm

C 255,10,0
F 220,170,0

111111
100101
101001
1100N1
111111
