WE ./cube/image/WallL.xpm
EA ./cube/image/WallR.xpm
SO ./cube/image/WallD.xpm
NO ./cube/image/WallU.xpm

F 101,67,33
C 0,0,255

1111111
10000N1
1000001
1111111