EA ./cube/image/WallR.xpm
WE ./cube/image/WallL.xpm
SO ./cube/image/WallD.xpm
NO ./cube/image/WallU.xpm

F 176, 249, 6
C 6, 70,249

111111111111111111111111111111111111111111111111
100000000000000000000000000000000000000000000001
100000000000000000000000000000010000000000000001
100000000000000000000000000000000000000000000001
100000000000000000000S00000000000000000000000001
100000000000000000000000000000010000000000000001
100000000000000011100000000000000000000000000001
100000000000000000100000000000000000000000000001
100000000000000010100000000000010000000000000001
111111111111111111111111111111111111111111111111