F 220,100,40

C 255,30,80

EA ./cube/image/WallR.xpm
WE ./cube/image/WallL.xpm
SO ./cube/image/WallD.xpm
NO ./cube/image/WallU.xpm


11111111111111111111111111111111111111111
10000000000000000000000000000000000000001
100000000000000000000000S0000000000000001
10000000000000000000000000000000000000001
10000000000000000000000000000000000000001
11111111111111111111111111111111111111111