EA ./cube/image/WallR.xpm
NO ./cube/image/WallU.xpm
WE ./cube/image/WallL.xpm
SO ./cube/image/WallD.xpm

F 220,170,0
C 255,10,0

111111
1S0101
111111



