
EA  ./cube/image/WallR.xpm
WE     ./cube/image/WallL.xpm
SO  ./cube/image/WallD.xpm
NO   ./cube/image/WallU.xpm

F   220   ,100,0
C   250,30,0


1111111111111
1000000000001
100000000000011111111111111111111111111111111111
100000000000000000000000000000000000000000000001
100000000000000000000000000000000000000000000001
100000000000000000000000000000010000000000000001
100000000000000000000000000000000000000000000001
100000000000000000000S00000000000000000000000001
100000000000000000000000000000010000000000000001
100000000000000011100000000000000000000000000001
100000000000000000100000000000000000000000000001
100000000000000010100000000000010000000000000001
111111111111111111111111111111111111111111111111