11111111111111
10000000000001
10000011110001
10000010010001
10000010110001
1S000000000001
11111111111111