1111111
1000W11
1000111
1111111