1111111
1000P11
1010111
1111111