1111111
1000N01
1000001
1111111