1111111
1000N11
1010111
1111111