F 220,100,40

C 255,30,80

EA ./cube/image/WallR.xpm
WE ./cube/image/WallL.xpm
SO ./cube/image/WallD.xpm
NO ./cube/image/WallU.xpm

11111
10001
10S01
10001
10001
10001
11001
10001
10001
10001
10001
100010
11111