EA insert_texture
WE insert_texture
SO insert_texture
NO insert_texture

F R,G,B
C R,G,B

11111
1MAP1
11111