
EA ./cube/image/WallR.xpm
WE ./cube/image/WallL.xpm
SO ./cube/image/WallD.xpm
NO ./cube/image/WallU.xpm

F 101,67,33
C 0,255,

1111111
1000N01
1000001
1111111