EA  ./cube/image/WallR.xpm
WE     ./cube/image/WallL.xpm
SO  ./cube/image/WallD.xpm
NO   ./cube/image/WallU.xpm

F   220,100,0
C   250,30,0




11111111111111111111111111
1000000000000000000001
10000000000000000000011
100000000000000  0000001
1000000000000000000001111
100000000000   S0000000001
10000000000000000000000011
100000011100000000000111
1000000001000  000000001
100000010100000000000111
1111111111111111111111
