F 101,67,33

C 0,0,255

EA ./cube/image/WallR.xpm
WE ./cube/image/WallL.xpm
SO ./cube/image/WallD.xpm
NO ./cube/image/WallU.xpm


1111111
1000N01
1000001
1111111




1