
EA ./cube/image/WallR.xpm
WE ./cube/image/Wal0L.xpm
SO ./cube/image/WallD.xpm
NO ./cube/essere/mangiare/bere.xpm

F 220,100,0
C 255,30,0

1111111111111111111
10W0000000000000001
1111111111111111111