1111011
1000W01
1000001
1111111
