F 220,100,0

C 255,30,0

EA ./cube/image/WallR.xpm
WE ./cube/image/WallL.xpm
SO ./cube/image/WallD.xpm
NO ./cube/image/WallU.xpm


1111111111111111111
14W0000000000000001
1111111111111111111