EA ./cube/image/WallR.xpm
WE ./cube/image/WallL.xpm
SO ./cube/image/WallD.xpm
NO ./cube/image/WallU.xpm

F 220,100,0
C 255,30,0

1111111
1000S00
1000001
1111111
