1111111111111111111
14W0000000000000001
1111111111111111111