WE ./cube/image/WallL.xpm
SO ./cube/image/WallD.xpm
NO ./cube/image/WallU.xpm

F 220,100,0
C 255,30,0

111111111111111111111111
100000000000000000N00001
100000000000000000000001
100000000000000000000001
111111111111111111111111