111111111111
1ESWN0000001
111111111111