F 220,100,0

C 255,30,0

EA ./cube/image/WallR.xpm
WE ./cube/image/WallL.xpm
SO ./cube/image/WallD.xpm
NO ./cube/image/WallU.xpm


111111111111
1ESWN0000001
111111111111